WWWWWWWWWWWWWWWW
WB00W0BBB0W00b0W
W0b0B0BWB0W0B00W
WB00W00000W00B0W
W0BWW00W00WB00WW
W00000W0W000000W
WWW00W0B0W0b0WWW
WB0b00W0W00000BW
WWW0000W00000WWW
W0000000B000000W
W00000000000000W
WWBWW00000WW00BW
WB00000000W0b00W
WB00W0BBB0B000WW
W10BW0BWB000B00W
WWWWWWWWWWWWWWWW